#B    ####
##### ####
#      ###
###### ###
#####A ###
